11111111111111111111111111111
100000000000C111C000000000001
10111101111101110111110111101
1C1111011111011101111101111C1
10111101111101110111110111101
10000000000000C00000000000001
10111101101111111110110111101
10111101101111111110110111101
100000C110000111000011C000001
11111101111101110111110111111
11111101111101110111110111111
11111101100000C00000110111111
11111101101111E11110110111111
11111101101000000010110111111
1C0000000010000000100000000C1
11111101101000000010110111111
11111101101111111110110111111
11111101100000P00000110111111
11111101101111111110110111111
11111101101111111110110111111
1000000C0000011100000C0000001
10111101111101110111110111101
10111101111101110111110111101
1C001100000000C000000001100C1
11101101101111111110110110111
11101101101111111110110110111
10000001100001110000110000001
1C1111111111011101111111111C1
10111111111101110111111111101
10000000000000C00000000000001
11111111111111111111111111111