1111111111111111111111111111111111111111111111111111
1111101000011100010010010100001110111110001011100001
1111100100111101111000101100110000011010011111111111
1100011111100101111001101000111101010100110000000111
1100101111100011110010011110111000110111100000010001
1100011010110001000110011000011111101011000100000001
1110001000000011110010110110110010110010101110011001
1101100010100111110000010001100111110010001010001101
1101101011100100011110111001100111001100100100010101
1000100111100000011110010101111111010011000100110101
1100111110110111010111100000011100011101011111000111
1111000011000010100110100000000101001000110110100011
1010101001110111100011111100001110111010100010110101
1101010110000101111110101110001011111101011001001111
1001100101011100110001000101010111111100010011110111
1100110100000010000001000100110100010011010000110011
1010000001001011111001010111000001010100110010011001
1111001000011110011100101100110100111110111111101111
1100110011001000011011001000111011111010110110001011
1000111110110101100101110110010100110000011011000111
1001010000011011010010111011000111001110101101101111
1110100111110010010110001001000011010000101001001011
1110101110111101000010111010011101001110100011011001
1111111011001001001000001111011101000011C00000110001
1010000000011111000011110001101001100000P10110000011
1010111110010110011101001101011011100100000011111001
1010011000110100010110011110011001100000001100011111
1100100010110101101111000010110101101100010010100101
1101010110000011001110101000010000001100011011110001
11000010001011010000100001111100E0111111110101010111
1001001000101110111001001101111110001101100101110111
1011110101110001001010101011001001111110011001100011
1101001111111100110010000001011101111000110001111111
1000000101001100000110010100110011000000010001010001
1011001111000001001110101010100001110110001101100111
1010011101101010001101010110100100001001100010100101
1111111111111111111111111111111111111111111111111111