1111111
1PC0111
10C0111
10C0111
10C0111
10C0111
10C0111
10C0111
10C0111
1E00111
1111111