11111111111111111111111
10000010000010000000111
100C0000011000011110111
1001111111111101111C111
11000011100000011110111
1011101110111000000P111
10000011100000111100111
1E111111101110C00001111
1C000000001000111100111
1C000000001000111100111
11111111111111111111111